000000000000000000000000000000000000000000000000000000000000000000000000000000000000000000000
000111111111111111111111111111111111111111111111111111111111111111111111111111111111111111000
000111111111111111111111111111111111111111111111111111111111111111111111111111111111111111000
000111111111111111111111111111111111111111111111111111111111111111111111111111111111111111000
000111111111111111111111111111111111111111111111111111111111111111111111111111111111111111000
000111100000000000000000000000000000000000000000000000000000000000000000000000000000001111000
000111100000000000000000000000000000000000000000000000000000000000000000000000000000001111000
000111100000000000000000000000000000000000000000000000000000000000000000000000000000001111000
000111100000000000000000000000000000000000000000000000000000000000000000000000000000001111000
000111100000000000000000000000000000000000000000000000000000000000000000000000000000001111000
000111100000000000000000000000000000000000000000000000000000000000000000000000000000001111000
000111100000000000000000000000000000000000000000000000000000000000000000000000000000001111000
000111100000000000000000000000000000000000000000000000000000000000000000000000000000001111000
000111111111111111111111111111111111111111111111111111111111111111111111111111111111111111000
000111111111111111111111111111111111111111111111111111111111111111111111111111111111111111000
000111111111111111111111111111111111111111111111111111111111111111111111111111111111111111000
000111111111111111111111111111111111111111111111111111111111111111111111111111111111111111000
000000000000000000000000000000000000000000000000000000000000000000000000000000000000000000000
000000000000000000000000000000000000000000000000000000000000000000000000000000000000000000000
000000000000000000000000000000000000000000000000000000000000000000000000000000000000000000000
000000000000000000000000000000000000000000000000000000000000000000000000000000000000000000000
000000000000000000000000000000000000000000000000000000000000000000000000000000000000000000000
000000000000000000000000000000000000000000000000000000000000000000000000000000000000000000000
000000000000000000000000000000000000000000000000000000000000000000000000000000000000000000000
000000000000000000000000000000000000000000000000000000000000000000000000000000000000000000000
000000000000000000000000000000000000000000000000000000000000000000000000000000000000000000000
000000000000000000000000000000000000000000000000000000000000000000000000000000000000000000000
000000000000000000000000000000000000000000000000000000000000000000000000000000000000000000000
000000000000000000000000000000000000000000000000000000000000000000000000000000000000000000000
000000000000000000000000000000000000000000000000000000000000000000000000000000000000000000000
000000000000000000000000000000000000000000000000000000000000000000000000000000000000000000000
000000000000000000000000000000000000000000000000000000000000000000000000000000000000000000000
000000000000000000000000000000000000000000000000000000000000000000000000000000000000000000000
000000000000000000000000000000000000000000000000000000000000000000000000000000000000000000000
000000000000000000000000000000000000000000000000000000000000000000000000000000000000000000000
000000000000000000000000000000000000000000000000000000000000000000000000000000000000000000000
000000000000000000000000000000000000000000000000000000000000000000000000000000000000000000000
000000000000000000000000000000000000000000000000000000000000000000000000000000000000000000000
000000000000000000000000000000000000000000000000000000000000000000000000000000000000000000000
000000000000000000000000000000000000000000000000000000000000000000000000000000000000000000000
000000000000000000000000000000000000000000000000000000000000000000000000000000000000000000000
000000000000000000000000000000000000000000000000000000000000000000000000000000000000000000000
000000000000000000000000000000000000000000000000000000000000000000000000000000000000000000000
000000000000000000000000000000000000000000000000000000000000000000000000000000000000000000000
000000000000000000000000000000000000000000000000000000000000000000000000000000000000000000000
000000000000000000000000000000000000000000000000000000000000000000000000000000000000000000000
000000000000000000000000000000000000000000000000000000000000000000000000000000000000000000000