999999999999999999999999999999999999999999999999999999999999999999999999999999999999999999999999999999999999999999999999
999999999999999999999999999999999999999999999999999999999999999999999999999999999999999999999999999999999999999999999999
999999999999999999999999999999999999999999999999999999999999999999999999999999999999999999999999999999999999999999999999
999999999999999999999999999999999999999999999999999999999999999999999999999999999999999999999999999999999999999999999999
999933333333333333333333333333333333333333333333333333333333333333333333333333333333333333333333333333333333333333339999
999940000000000000000000000000000000000000000000000000000000000000000000000000000000000000000000000000000000000000029999
999940000000000000000000000000000000000000000000000000000000000000000000000000000000000000000000000000000000000000029999
999940000000000000000000000000000000000000000000000000000000000000000000000000000000000000000000000000000000000000029999
999940000000000000000000000000000000000000000000000000000000000000000000000000000000000000000000000000000000000000029999
999940000000000000000000000000000000000000000000000000000000000000000000000000000000000000000000000000000000000000029999
999940000000000000000000000000000000000000000000000000000000000000000000000000000000000000000000000000000000000000029999
999940000000000000000000000000000000000000000000000000000000000000000000000000000000000000000000000000000000000000029999
999940000000000000000000000000000000000000000000000000000000000000000000000000000000000000000000000000000000000000029999
999940000000000000000000000000000000000000000000000000000000000000000000000000000000000000000000000000000000000000029999
999940000000000000000000000000000000000000000000000000000000000000000000000000000000000000000000000000000000000000029999
999940000000000000000000000000000000000000000000000000000000000000000000000000000000000000000000000000000000000000029999
999940000000000000000000000000000000000000000000000000000000000000000000000000000000000000000000000000000000000000029999
999940000000000000000000000000000000000000000000000000000000000000000000000000000000000000000000000000000000000000029999
999940000000000000611111111111111111111111111111111111111111111111111111111111111111111111111111111115000000000000029999
999940000000000000299999999999999999999999999999999999999999999999999999999999999999999999999999999994000000000000029999
999940000000000000299999999999999999999999999999999999999999999999999999999999999999999999999999999994000000000000029999
999940000000000000299999999999999999999999999999999999999999999999999999999999999999999999999999999994000000000000029999
999940000000000000299999999999999999999999999999999999999999999999999999999999999999999999999999999994000000000000029999
999940000000000000299999999999999999999999999999999999999999999999999999999999999999999999999999999994000000000000029999
999940000000000000299999999999999999999999999999999999999999999999999999999999999999999999999999999994000000000000029999
999940000000000000299999999999999999999999999999999999999999999999999999999999999999999999999999999994000000000000029999
999940000000000000299999999999999999999999999999999999999999999999999999999999999999999999999999999994000000000000029999
999940000000000000299999999999999999999999999999999999999999999999999999999999999999999999999999999994000000000000029999
999940000000000000299999999999999999999999999999999999999999999999999999999999999999999999999999999994000000000000029999
999940000000000000299999999999999999999999999999999999999999999999999999999999999999999999999999999994000000000000029999
999940000000000000299999999999999999999999999999999999999999999999999999999999999999999999999999999994000000000000029999
999940000000000000299999999999999999999999999999999999999999999999999999999999999999999999999999999994000000000000029999
999940000000000000299999999999999999999999999999999999999999999999999999999999999999999999999999999994000000000000029999
999940000000000000299999999999999999999999999999999999999999999999999999999999999999999999999999999994000000000000029999
999940000000000000299999999999999999999999999999999999999999999999999999999999999999999999999999999994000000000000029999
999940000000000000299999999999999999999999999999999999999999999999999999999999999999999999999999999994000000000000029999
999940000000000000299999999999999999999999999999999999999999999999999999999999999999999999999999999994000000000000029999
999940000000000000299999999999999999999999999999999999999999999999999999999999999999999999999999999994000000000000029999
999940000000000000299999999999999999999999999999999999999999999999999999999999999999999999999999999994000000000000029999
999940000000000000299999999999999999999999999999999999999999999999999999999999999999999999999999999994000000000000029999
999940000000000000299999999999999999999999999999999999999999999999999999999999999999999999999999999994000000000000029999
999940000000000000299999999999999999999999999999999999999999999999999999999999999999999999999999999994000000000000029999
999940000000000000299999999999999999999999999999999999999999999999999999999999999999999999999999999994000000000000029999
999940000000000000299999999999999999999999999999999999999999999999999999999999999999999999999999999994000000000000029999
999940000000000000299999999999999999999999999999999999999999999999999999999999999999999999999999999994000000000000029999
999940000000000000299999999999999999999999999999999999999999999999999999999999999999999999999999999994000000000000029999
999940000000000000299999999999999999999999999999999999999999999999999999999999999999999999999999999994000000000000029999
999940000000000000299999999999999999999999999999999999999999999999999999999999999999999999999999999994000000000000029999
999940000000000000299999999999999999999999999999999999999999999999999999999999999999999999999999999994000000000000029999
999940000000000000299999999999999999999999999999999999999999999999999999999999999999999999999999999994000000000000029999
999940000000000000299999999999999999999999999999999999999999999999999999999999999999999999999999999994000000000000029999
999940000000000000299999999999999999999999999999999999999999999999999999999999999999999999999999999994000000000000029999
999940000000000000299999999999999999999999999999999999999999999999999999999999999999999999999999999994000000000000029999
999940000000000000299999999999999999999999999999999999999999999999999999999999999999999999999999999994000000000000029999
999940000000000000299999999999999999999999999999999999999999999999999999999999999999999999999999999994000000000000029999
999940000000000000299999999999999999999999999999999999999999999999999999999999999999999999999999999994000000000000029999
999940000000000000299999999999999999999999999999999999999999999999999999999999999999999999999999999994000000000000029999
999940000000000000299999999999999999999999999999999999999999999999999999999999999999999999999999999994000000000000029999
999940000000000000299999999999999999999999999999999999999999999999999999999999999999999999999999999994000000000000029999
999940000000000000299999999999999999999999999999999999999999999999999999999999999999999999999999999994000000000000029999
999940000000000000299999999999999999999999999999999999999999999999999999999999999999999999999999999994000000000000029999
999940000000000000299999999999999999999999999999999999999999999999999999999999999999999999999999999994000000000000029999
999940000000000000833333333333333333333333333333333333333333333333333333333333333333333333333333333337000000000000029999
999940000000000000000000000000000000000000000000000000000000000000000000000000000000000000000000000000000000000000029999
999940000000000000000000000000000000000000000000000000000000000000000000000000000000000000000000000000000000000000029999
999940000000000000000000000000000000000000000000000000000000000000000000000000000000000000000000000000000000000000029999
999940000000000000000000000000000000000000000000000000000000000000000000000000000000000000000000000000000000000000029999
999940000000000000000000000000000000000000000000000000000000000000000000000000000000000000000000000000000000000000029999
999940000000000000000000000000000000000000000000000000000000000000000000000000000000000000000000000000000000000000029999
999940000000000000000000000000000000000000000000000000000000000000000000000000000000000000000000000000000000000000029999
999940000000000000000000000000000000000000000000000000000000000000000000000000000000000000000000000000000000000000029999
999940000000000000000000000000000000000000000000000000000000000000000000000000000000000000000000000000000000000000029999
999940000000000000000000000000000000000000000000000000000000000000000000000000000000000000000000000000000000000000029999
999940000000000000000000000000000000000000000000000000000000000000000000000000000000000000000000000000000000000000029999
999940000000000000000000000000000000000000000000000000000000000000000000000000000000000000000000000000000000000000029999
999940000000000000000000000000000000000000000000000000000000000000000000000000000000000000000000000000000000000000029999
999911111111111111111111111111111111111111111111111111111111111111111111111111111111111111111111111111111111111111119999
999999999999999999999999999999999999999999999999999999999999999999999999999999999999999999999999999999999999999999999999
999999999999999999999999999999999999999999999999999999999999999999999999999999999999999999999999999999999999999999999999
999999999999999999999999999999999999999999999999999999999999999999999999999999999999999999999999999999999999999999999999
999999999999999999999999999999999999999999999999999999999999999999999999999999999999999999999999999999999999999999999999
